R 1048 1080
NO  ./pics/greystone.xpm
SO ./pics/redbrick.xpm
WE ./pics/purplestone.xpm
EA ./pics/mossy.xpm
S ./pics/armor.xpm
C 0,0,30
F 70,70,70

11111       1111            11111111
10001       1001            100S0011
110011111111100111111111111110000001
100000000000000000000000000000002001
100000001111110000000000000000000001
100000001    10000000020000000000011
100000001    10000000020000000000011
100000001    10000000020000000000011
1000200011 1110000000020000000000001
1000000001110000000000000000000000011
1111000000000000001111111111111111111
   1111100000111111
       1002001
       1000001
       1000001
       10000011
       110000011
1111111100000011111111111111
100000000000000000000001
100000000000000000000001
111111111111111111111111